adfecgdb	Abdominal and Direct Fetal ECG Database
aftdb	AF Termination Challenge Database
ahadb	AHA Database [sample excluded record]
aami-ec13	ANSI/AAMI EC13 Test Waveforms
apnea-ecg	Apnea-ECG Database
chfdb	BIDMC Congestive Heart Failure Database
bidmc	BIDMC PPG and Respiration Dataset
bpssrat	Blood Pressure in Salt-Sensitive Dahl Rats
capslpdb	CAP Sleep Database
crisdb	CAST RR Interval Sub-Study Database
cves	Cerebral Vasoregulation in Elderly with Stroke
charisdb	CHARIS database
chbmit	CHB-MIT Scalp EEG Database
ecgcipa	CiPA ECG Validation Study
cebsdb	Combined measurement of ECG, Breathing and Seismocardiograms
culm	Complex Upper-Limb Movements
chf2db	Congestive Heart Failure RR Interval Database
ctu-uhb-ctgdb	CTU-CHB Intrapartum Cardiotocography Database
cudb	CU Ventricular Tachyarrhythmia Database
ecgdmmld	ECG Effects of Dofetilide, Moxifloxacin, Dofetilide+Mexiletine, Dofetilide+Lidocaine and Moxifloxacin+Diltiazem
ecgrdvq	ECG Effects of Ranolazine, Dofetilide, Verapamil, and Quinidine
ecgiddb	ECG-ID Database
eegmat	EEG During Mental Arithmetic Tasks
eegmmidb	EEG Motor Movement/Imagery Dataset
ltrsvp	EEG Signals from an RSVP Task
erpbci	ERP-based Brain-Computer Interface recordings
edb	European ST-T Database
earh	Evoked Auditory Responses in Heading Impaired
earndb	Evoked Auditory Responses in Normals
emgdb	Examples of Electromyograms
fantasia	Fantasia Database
fecgsyndb	Fetal ECG Synthetic Database
fpcgdb	Fetal PCG Database
gaitdb	Gait in Aging and Disease Database
gaitndd	Gait in Neurodegenerative Disease Database
gait-maturation-db	Gait Maturation Database
meditation	Heart Rate Oscillations during Meditation
hbedb	Human Balance Evaluation Database
ehgdb	Icelandic 16-electrode Electrohysterogram Database
iafdb	Intracardiac Atrial Fibrillation Database
ltafdb	Long Term AF Database
ltstdb	Long Term ST Database
mssvepdb	MAMEM SSVEP Database
mghdb	MGH/MF Waveform Database
mimicdb	MIMIC Database
mitdb	MIT-BIH Arrhythmia Database
pwave	MIT-BIH Arrhythmia Database P-Wave Annotations
afdb	MIT-BIH Atrial Fibrillation Database
cdb	MIT-BIH ECG Compression Test Database
ltdb	MIT-BIH Long-Term ECG Database
vfdb	MIT-BIH Malignant Ventricular Ectopy Database
nstdb	MIT-BIH Noise Stress Test Database
nsrdb	MIT-BIH Normal Sinus Rhythm Database
excluded	Recordings excluded from the NSR DB
slpdb	MIT-BIH Polysomnographic Database
stdb	MIT-BIH ST Change Database
svdb	MIT-BIH Supraventricular Arrhythmia Database
mmgdb	MMG Database
macecgdb	Motion Artifact Contaminated ECG Database
motion-artifact	Motion Artifact Contaminated fNIRS and EEG Data
noneeg	Non-EEG Dataset for Assessment of Neurological Status
nifecgdb	Non-Invasive Fetal ECG Database
nsr2db	Normal Sinus Rhythm RR Interval Database
ob1db	OB-1 Fetal ECG Database [sample record]
afpdb	PAF Prediction Challenge Database
osv	Pattern Analysis of Oxygen Saturation Variability
prcp	Physiologic Response to Changes in Posture
szdb	Post-Ictal Heart Rate Oscillations in Partial Epilepsy
picsdb	Preterm Infant Cardio-Respiratory Signals Database
ptbdb	PTB Diagnostic ECG Database
qtdb	QT Database
rvmh1	Response to Valsalva Maneuver in Humans
sufhsdb	Shiraz University Fetal Heart Sounds Database
simfpcgdb	Simulated Fetal Phonocardiograms
sleepbrl	Sleep Bioradiolocation Database
sleep-edfx	Sleep-EDF Database [Expanded]
shhpsgdb	Sleep Heart Health Study PSG Database [sample record]
shareedb	Smart Health for Assessing the Risk of Events via ECG Database
mvtdb	Spontaneous Ventricular Tachyarrhythmia Database
sgamp	Squid Giant Axon Membrane Potential
incartdb	St Petersburg INCART 12-lead Arrhythmia Database
staffiii	STAFF III Database
drivedb	Stress Recognition in Automobile Drivers
sddb	Sudden Cardiac Death Holter Database
twadb	T-Wave Alternans Challenge Database
taichidb	Tai Chi, Physiological Complexity, and Healthy Aging - Gait
tpehgdb	Term-Preterm EHG Database
tpehgt	Term-Preterm EHG DataSet with Tocogram (TPEHGT DS)
ucddb	UCD Sleep Apnea Database
unicaprop	UniCA ElectroTastegram Database (PROP)
videopulse	Video Pulse Signals in Stationary and Motion Conditions
voiced	VOice ICar fEDerico II Database
wrist	Wrist PPG During Exercise
